5000,203,38,165,0,0
10000,246,48,198,0,0
15000,355,63,292,0,0
20000,604,109,495,0,0
25000,766,128,638,0,0
30000,901,143,758,0,0
35000,1156,186,970,0,0
40000,1346,224,1122,0,0
45000,1467,240,1227,0,0
50000,1622,261,1361,0,0
55000,1692,269,1423,0,0
60000,1773,271,1502,0,0
65000,1870,283,1587,0,0
70000,1962,306,1656,0,0
75000,2069,321,1748,0,0
80000,2215,338,1877,0,0
85000,2296,350,1946,0,0
90000,2341,351,1990,0,0
95000,2386,355,2031,0,0
100000,2453,359,2094,0,0
105000,2561,373,2188,0,0
110000,2683,377,2306,0,0
115000,2744,380,2364,0,0
120000,2831,385,2446,0,0
125000,2928,399,2529,0,0
130000,2980,403,2577,0,0
135000,3071,420,2651,0,0
140000,3165,431,2734,0,0
145000,3307,466,2841,0,0
150000,3406,477,2929,0,0
155000,3497,488,3009,0,0
160000,3593,493,3100,0,0
165000,3720,505,3215,0,0
170000,3804,511,3293,0,0
175000,3921,521,3400,0,0
180000,3988,533,3455,0,0
185000,4048,541,3507,0,0
190000,4270,562,3708,0,0
195000,4389,574,3815,0,0
200000,4512,586,3926,0,0
205000,4662,595,4067,0,0
210000,4712,600,4112,0,0
215000,4794,608,4186,0,0
220000,4988,638,4350,0,0
225000,5071,649,4422,0,0
230000,5255,674,4581,0,0
235000,5430,704,4726,0,0
240000,5543,718,4825,0,0
245000,5602,723,4879,0,0
250000,5682,732,4950,0,0
255000,5776,741,5035,0,0
260000,5891,754,5137,0,0
265000,5981,764,5217,0,0
270000,6080,780,5300,0,0
275000,6269,822,5447,0,0
280000,6355,829,5526,0,0
285000,6539,870,5669,0,0
290000,6716,902,5814,0,0
295000,6881,934,5947,0,0
300000,6938,938,6000,0,0
305000,7062,955,6107,0,0
310000,7133,969,6164,0,0
315000,7332,997,6335,0,0
320000,7419,1003,6416,0,0
325000,7530,1015,6515,0,0
330000,7680,1035,6645,0,0
335000,7851,1058,6793,0,0
340000,7994,1076,6918,0,0
345000,8136,1085,7051,0,0
350000,8215,1096,7119,0,0
355000,8395,1112,7283,0,0
360000,8522,1126,7396,0,0
365000,8622,1136,7486,0,0
370000,8762,1151,7611,0,0
375000,8911,1170,7741,0,0
380000,8948,1171,7777,0,0
385000,9030,1180,7850,0,0
390000,9248,1220,8028,0,0
395000,9401,1240,8161,0,0
400000,9567,1257,8310,0,0
405000,9762,1279,8483,0,0
410000,9950,1316,8634,0,0
415000,10177,1351,8826,0,0
420000,10338,1376,8962,0,0
425000,10418,1385,9033,0,0
430000,10566,1401,9165,0,0
435000,10664,1411,9253,0,0
440000,10811,1424,9387,0,0
445000,10961,1441,9520,0,0
450000,11196,1469,9727,0,0
455000,11352,1493,9859,0,0
460000,11560,1544,10016,0,0
465000,11658,1552,10106,0,0
470000,11812,1569,10243,0,0
475000,11969,1594,10375,0,0
480000,12109,1610,10499,0,0
485000,12264,1633,10631,0,0
490000,12498,1658,10840,0,0
495000,12604,1675,10929,0,0
500000,12777,1699,11078,0,0
505000,12941,1721,11220,0,0
510000,13092,1740,11352,0,0
515000,13245,1767,11478,0,0
520000,13389,1790,11599,0,0
525000,13539,1815,11724,0,0
530000,13621,1821,11800,0,0
535000,13763,1850,11913,0,0
540000,13896,1853,12043,0,0
545000,13979,1859,12120,0,0
550000,14056,1867,12189,0,0
555000,14128,1870,12258,0,0
560000,14271,1881,12390,0,0
565000,14485,1914,12571,0,0
570000,14609,1933,12676,0,0
575000,14861,1960,12901,0,0
580000,14964,1971,12993,0,0
585000,15121,1987,13134,0,0
590000,15198,1991,13207,0,0
595000,15398,2021,13377,0,0
600000,15483,2028,13455,0,0
605000,15624,2050,13574,0,0
610000,15782,2065,13717,0,0
615000,15865,2070,13795,0,0
620000,15993,2077,13916,0,0
625000,16164,2094,14070,0,0
630000,16348,2108,14240,0,0
635000,16473,2124,14349,0,0
640000,16606,2139,14467,0,0
645000,16719,2149,14570,0,0
650000,16850,2185,14665,0,0
655000,16999,2205,14794,0,0
660000,17105,2220,14885,0,0
665000,17242,2233,15009,0,0
670000,17344,2249,15095,0,0
675000,17484,2267,15217,0,0
680000,17571,2275,15296,0,0
685000,17751,2303,15448,0,0
690000,17918,2327,15591,0,0
695000,18024,2336,15688,0,0
700000,18153,2346,15807,0,0
705000,18250,2360,15890,0,0
710000,18339,2370,15969,0,0
715000,18415,2373,16042,0,0
720000,18556,2398,16158,0,0
725000,18738,2432,16306,0,0
730000,18846,2449,16397,0,0
735000,18946,2462,16484,0,0
740000,19032,2470,16562,0,0
745000,19189,2489,16700,0,0
750000,19345,2503,16842,0,0
755000,19488,2520,16968,0,0
760000,19596,2530,17066,0,0
765000,19697,2541,17156,0,0
770000,19827,2556,17271,0,0
775000,19941,2570,17371,0,0
780000,20064,2577,17487,0,0
785000,20206,2598,17608,0,0
790000,20355,2609,17746,0,0
795000,20513,2625,17888,0,0
800000,20636,2640,17996,0,0
805000,20778,2659,18119,0,0
810000,20929,2673,18256,0,0
815000,21063,2688,18375,0,0
820000,21163,2702,18461,0,0
825000,21254,2712,18542,0,0
830000,21440,2728,18712,0,0
835000,21565,2743,18822,0,0
840000,21646,2756,18890,0,0
845000,21786,2779,19007,0,0
850000,21922,2785,19137,0,0
855000,22117,2791,19326,0,0
860000,22174,2793,19381,0,0
865000,22295,2798,19497,0,0
870000,22332,2801,19531,0,0
875000,22426,2806,19620,0,0
880000,22720,2832,19888,0,0
885000,22814,2838,19976,0,0
890000,23000,2854,20146,0,0
895000,23131,2864,20267,0,0
900000,23253,2873,20380,0,0
905000,23359,2891,20468,0,0
910000,23432,2903,20529,0,0
915000,23513,2916,20597,0,0
920000,23637,2928,20709,0,0
925000,23733,2936,20797,0,0
930000,23865,2955,20910,0,0
935000,23993,2962,21031,0,0
940000,24116,2974,21142,0,0
945000,24225,2984,21241,0,0
950000,24282,2991,21291,0,0
955000,24378,3003,21375,0,0
960000,24543,3021,21522,0,0
965000,24622,3030,21592,0,0
970000,24766,3043,21723,0,0
975000,24905,3063,21842,0,0
980000,24996,3085,21911,0,0
985000,25099,3096,22003,0,0
990000,25198,3116,22082,0,0
995000,25280,3138,22142,0,0
1000000,25380,3151,22229,0,0
1005000,25460,3161,22299,0,0
1010000,25556,3166,22390,0,0
1015000,25689,3181,22508,0,0
1020000,25715,3184,22531,0,0
1025000,25811,3197,22614,0,0
1030000,25953,3215,22738,0,0
1035000,26028,3218,22810,0,0
1040000,26092,3221,22871,0,0
1045000,26192,3226,22966,0,0
1050000,26279,3232,23047,0,0
1055000,26365,3242,23123,0,0
1060000,26467,3254,23213,0,0
1065000,26550,3262,23288,0,0
1070000,26683,3280,23403,0,0
1075000,26764,3285,23479,0,0
1080000,26830,3288,23542,0,0
1085000,26898,3289,23609,0,0
1090000,26958,3290,23668,0,0
1095000,27043,3298,23745,0,0
1100000,27146,3303,23843,0,0
1105000,27231,3312,23919,0,0
1110000,27321,3321,24000,0,0
1115000,27409,3330,24079,0,0
1120000,27544,3344,24200,0,0
1125000,27584,3346,24238,0,0
1130000,27703,3358,24345,0,0
1135000,27818,3368,24450,0,0
1140000,27912,3380,24532,0,0
1145000,28108,3416,24692,0,0
1150000,28425,3458,24967,0,0
1155000,28545,3468,25077,0,0
1160000,28644,3478,25166,0,0
1165000,28763,3494,25269,0,0
1170000,28951,3526,25425,0,0
1175000,29037,3532,25505,0,0
1180000,29209,3557,25652,0,0
1185000,29316,3574,25742,0,0
1190000,29692,3640,26052,0,0
1195000,29898,3671,26227,0,0
1200000,30085,3700,26385,0,0
1205000,30367,3728,26639,0,0
1210000,30494,3738,26756,0,0
1215000,30578,3748,26830,0,0
1220000,30730,3768,26962,0,0
1225000,30809,3775,27034,0,0
1230000,30956,3789,27167,0,0
1235000,31101,3814,27287,0,0
1240000,31205,3826,27379,0,0
1245000,31303,3836,27467,0,0
1250000,31449,3860,27589,0,0
1255000,31520,3873,27647,0,0
1260000,31604,3882,27722,0,0
1265000,31721,3893,27828,0,0
1270000,31811,3903,27908,0,0
1275000,31872,3911,27961,0,0
1280000,31958,3919,28039,0,0
1285000,32089,3924,28165,0,0
1290000,32174,3948,28226,0,0
1295000,32258,3955,28303,0,0
1300000,32324,3960,28364,0,0
1305000,32451,3974,28477,0,0
1310000,32607,3991,28616,0,0
1315000,32746,4007,28739,0,0
1320000,32867,4016,28851,0,0
1325000,32922,4019,28903,0,0
1330000,33018,4033,28985,0,0
1335000,33123,4040,29083,0,0
1340000,33173,4044,29129,0,0
1345000,33215,4051,29164,0,0
1350000,33334,4054,29280,0,0
1355000,33443,4059,29384,0,0
1360000,33507,4063,29444,0,0
1365000,33605,4068,29537,0,0
1370000,33714,4080,29634,0,0
1375000,33786,4093,29693,0,0
1380000,33877,4097,29780,0,0
1385000,33969,4103,29866,0,0
1390000,34035,4108,29927,0,0
1395000,34159,4124,30035,0,0
1400000,34279,4131,30148,0,0
1405000,34310,4133,30177,0,0
1410000,34428,4139,30289,0,0
1415000,34483,4141,30342,0,0
1420000,34531,4147,30384,0,0
1425000,34599,4152,30447,0,0
1430000,34689,4159,30530,0,0
1435000,34766,4164,30602,0,0
1440000,34829,4169,30660,0,0
1445000,34922,4181,30741,0,0
1450000,35037,4190,30847,0,0
1455000,35106,4198,30908,0,0
1460000,35206,4208,30998,0,0
1465000,35311,4220,31091,0,0
1470000,35433,4226,31207,0,0
1475000,35540,4237,31303,0,0
1480000,35595,4238,31357,0,0
1485000,35643,4239,31404,0,0
1490000,35677,4240,31437,0,0
1495000,35744,4250,31494,0,0
1500000,35889,4274,31615,0,0
1505000,35927,4279,31648,0,0
1510000,36040,4288,31752,0,0
1515000,36125,4299,31826,0,0
1520000,36280,4308,31972,0,0
1525000,36338,4321,32017,0,0
1530000,36418,4329,32089,0,0
1535000,36497,4336,32161,0,0
1540000,36554,4339,32215,0,0
1545000,36657,4346,32311,0,0
1550000,36907,4370,32537,0,0
1555000,37014,4375,32639,0,0
1560000,37233,4410,32823,0,0
1565000,37320,4418,32902,0,0
1570000,37400,4427,32973,0,0
1575000,37469,4434,33035,0,0
1580000,37551,4442,33109,0,0
1585000,37716,4462,33254,0,0
1590000,37792,4464,33328,0,0
1595000,37933,4488,33445,0,0
1600000,38064,4505,33559,0,0
1605000,38155,4515,33640,0,0
1610000,38233,4524,33709,0,0
1615000,38384,4540,33844,0,0
1620000,38459,4549,33910,0,0
1625000,38514,4551,33963,0,0
1630000,38758,4569,34189,0,0
1635000,38839,4579,34260,0,0
1640000,39124,4631,34493,0,0
1645000,39290,4644,34646,0,0
1650000,39394,4648,34746,0,0
1655000,39499,4658,34841,0,0
1660000,39651,4675,34976,0,0
1665000,39802,4698,35104,0,0
1670000,39876,4707,35169,0,0
1675000,39943,4712,35231,0,0
1680000,40041,4715,35326,0,0
1685000,40143,4719,35424,0,0
1690000,40308,4763,35545,0,0
1695000,40461,4788,35673,0,0
1700000,40537,4796,35741,0,0
1705000,40690,4823,35867,0,0
1710000,40919,4857,36062,0,0
1715000,41063,4864,36199,0,0
1720000,41174,4877,36297,0,0
1725000,41271,4886,36385,0,0
1730000,41370,4892,36478,0,0
1735000,41516,4913,36603,0,0
1740000,41708,4930,36778,0,0
1745000,41860,4956,36904,0,0
1750000,41999,4990,37009,0,0
1755000,42098,5004,37094,0,0
1760000,42225,5021,37204,0,0
1765000,42411,5053,37358,0,0
1770000,42572,5062,37510,0,0
1775000,42656,5071,37585,0,0
1780000,42782,5085,37697,0,0
1785000,42879,5091,37788,0,0
1790000,43108,5127,37981,0,0
1795000,43253,5139,38114,0,0
1800000,43473,5183,38290,0,0
1805000,43621,5202,38419,0,0
1810000,43736,5211,38525,0,0
1815000,43801,5220,38581,0,0
1820000,43946,5231,38715,0,0
1825000,44088,5248,38840,0,0
1830000,44226,5266,38960,0,0
1835000,44305,5272,39033,0,0
1840000,44393,5282,39111,0,0
1845000,44519,5299,39220,0,0
1850000,44620,5307,39313,0,0
1855000,44722,5313,39409,0,0
1860000,44827,5328,39499,0,0
1865000,45032,5352,39680,0,0
1870000,45163,5365,39798,0,0
1875000,45318,5381,39937,0,0
1880000,45420,5393,40027,0,0
1885000,45539,5410,40129,0,0
1890000,45611,5429,40182,0,0
1895000,45709,5437,40272,0,0
1900000,45867,5454,40413,0,0
1905000,45966,5461,40505,0,0
1910000,46084,5473,40611,0,0
1915000,46170,5483,40687,0,0
1920000,46287,5492,40795,0,0
1925000,46416,5499,40917,0,0
1930000,46604,5530,41074,0,0
1935000,46701,5541,41160,0,0
1940000,46757,5546,41211,0,0
1945000,46854,5548,41306,0,0
1950000,46988,5560,41428,0,0
1955000,47123,5567,41556,0,0
1960000,47230,5578,41652,0,0
1965000,47273,5581,41692,0,0
1970000,47361,5588,41773,0,0
1975000,47491,5612,41879,0,0
1980000,47708,5640,42068,0,0
1985000,47756,5644,42112,0,0
1990000,47905,5663,42242,0,0
1995000,48026,5682,42344,0,0
2000000,48116,5687,42429,0,0
2005000,48256,5699,42557,0,0
2010000,48342,5706,42636,0,0
2015000,48409,5711,42698,0,0
2020000,48522,5728,42794,0,0
2025000,48653,5746,42907,0,0
2030000,48741,5751,42990,0,0
2035000,48869,5764,43105,0,0
2040000,48938,5772,43166,0,0
2045000,49096,5784,43312,0,0
2050000,49197,5794,43403,0,0
2055000,49242,5797,43445,0,0
2060000,49280,5805,43475,0,0
2065000,49325,5808,43517,0,0
2070000,49474,5815,43659,0,0
2075000,49528,5823,43705,0,0
2080000,49680,5849,43831,0,0
2085000,49853,5869,43984,0,0
2090000,50045,5885,44160,0,0
2095000,50232,5911,44321,0,0
2100000,50362,5918,44444,0,0
2105000,50496,5939,44557,0,0
2110000,50576,5948,44628,0,0
2115000,50750,5974,44776,0,0
2120000,50817,5984,44833,0,0
2125000,51018,6009,45009,0,0
2130000,51240,6043,45197,0,0
2135000,51394,6058,45336,0,0
2140000,51523,6072,45451,0,0
2145000,51694,6091,45603,0,0
2150000,51915,6124,45791,0,0
2155000,52052,6144,45908,0,0
2160000,52126,6148,45978,0,0
2165000,52193,6161,46032,0,0
2170000,52301,6175,46126,0,0
2175000,52452,6186,46266,0,0
2180000,52698,6228,46470,0,0
2185000,52874,6257,46617,0,0
2190000,53114,6306,46808,0,0
2195000,53293,6350,46943,0,0
2200000,53460,6366,47094,0,0
2205000,53630,6381,47249,0,0
2210000,53756,6403,47353,0,0
2215000,53863,6419,47444,0,0
2220000,54024,6442,47582,0,0
2225000,54373,6522,47851,0,0
2230000,54595,6566,48029,0,0
2235000,54929,6622,48307,0,0
2240000,55086,6640,48446,0,0
2245000,55262,6663,48599,0,0
2250000,55403,6682,48721,0,0
2255000,55517,6692,48825,0,0
2260000,55680,6714,48966,0,0
2265000,55836,6736,49100,0,0
2270000,55950,6753,49197,0,0
2275000,56092,6769,49323,0,0
2280000,56275,6791,49484,0,0
2285000,56422,6819,49603,0,0
2290000,56472,6824,49648,0,0
2295000,56595,6838,49757,0,0
2300000,56736,6852,49884,0,0
2305000,56897,6866,50031,0,0
2310000,56997,6879,50118,0,0
2315000,57212,6896,50316,0,0
2320000,57336,6908,50428,0,0
2325000,57393,6911,50482,0,0
2330000,57521,6927,50594,0,0
2335000,57589,6932,50657,0,0
2340000,57650,6935,50715,0,0
2345000,57737,6939,50798,0,0
2350000,57919,6974,50945,0,0
2355000,58010,6988,51022,0,0
2360000,58135,7007,51128,0,0
2365000,58282,7025,51257,0,0
2370000,58389,7037,51352,0,0
2375000,58528,7050,51478,0,0
2380000,58638,7055,51583,0,0
2385000,58711,7061,51650,0,0
2390000,58826,7065,51761,0,0
2395000,58915,7069,51846,0,0
2400000,59018,7081,51937,0,0
2405000,59107,7091,52016,0,0
2410000,59186,7098,52088,0,0
2415000,59263,7101,52162,0,0
2420000,59318,7106,52212,0,0
2425000,59394,7109,52285,0,0
2430000,59469,7114,52355,0,0
2435000,59707,7136,52571,0,0
2440000,59771,7138,52633,0,0
2445000,59854,7152,52702,0,0
2450000,59959,7163,52796,0,0
2455000,60044,7168,52876,0,0
2460000,60161,7177,52984,0,0
2465000,60218,7181,53037,0,0
2470000,60289,7185,53104,0,0
2475000,60343,7188,53155,0,0
2480000,60448,7194,53254,0,0
2485000,60536,7207,53329,0,0
2490000,60653,7218,53435,0,0
2495000,60698,7221,53477,0,0
2500000,60787,7233,53554,0,0
2505000,60846,7235,53611,0,0
2510000,60997,7248,53749,0,0
2515000,61103,7260,53843,0,0
2520000,61206,7271,53935,0,0
2525000,61340,7281,54059,0,0
2530000,61404,7287,54117,0,0
2535000,61549,7311,54238,0,0
2540000,61627,7320,54307,0,0
2545000,61687,7324,54363,0,0
2550000,61786,7332,54454,0,0
2555000,61870,7336,54534,0,0
2560000,61961,7345,54616,0,0
2565000,62049,7348,54701,0,0
2570000,62124,7352,54772,0,0
2575000,62176,7355,54821,0,0
2580000,62252,7362,54890,0,0
2585000,62309,7363,54946,0,0
2590000,62339,7366,54973,0,0
2595000,62409,7369,55040,0,0
2600000,62480,7376,55104,0,0
2605000,62577,7395,55182,0,0
2610000,62611,7398,55213,0,0
2615000,62668,7404,55264,0,0
2620000,62709,7407,55302,0,0
2625000,62761,7411,55350,0,0
2630000,62894,7434,55460,0,0
2635000,62941,7434,55507,0,0
2640000,63023,7442,55581,0,0
2645000,63099,7446,55653,0,0
2650000,63187,7451,55736,0,0
2655000,63272,7461,55811,0,0
2660000,63359,7478,55881,0,0
2665000,63393,7480,55913,0,0
2670000,63457,7483,55974,0,0
2675000,63525,7487,56038,0,0
2680000,63585,7493,56092,0,0
2685000,63642,7495,56147,0,0
2690000,63762,7506,56256,0,0
2695000,63850,7512,56338,0,0
2700000,63912,7517,56395,0,0
2705000,63990,7521,56469,0,0
2710000,64026,7524,56502,0,0
2715000,64153,7537,56616,0,0
2720000,64243,7542,56701,0,0
2725000,64403,7576,56827,0,0
2730000,64470,7578,56892,0,0
2735000,64523,7579,56944,0,0
2740000,64574,7581,56993,0,0
2745000,64636,7584,57052,0,0
2750000,64725,7590,57135,0,0
2755000,64803,7595,57208,0,0
2760000,64851,7597,57254,0,0
2765000,64989,7604,57385,0,0
2770000,65079,7608,57471,0,0
2775000,65125,7611,57514,0,0
2780000,65203,7617,57586,0,0
2785000,65247,7619,57628,0,0
2790000,65303,7623,57680,0,0
2795000,65397,7630,57767,0,0
2800000,65487,7644,57843,0,0
2805000,65544,7644,57900,0,0
2810000,65592,7646,57946,0,0
2815000,65679,7651,58028,0,0
2820000,65714,7652,58062,0,0
2825000,65802,7661,58141,0,0
2830000,65930,7684,58246,0,0
2835000,66026,7696,58330,0,0
2840000,66079,7701,58378,0,0
2845000,66126,7704,58422,0,0
2850000,66153,7704,58449,0,0
2855000,66187,7704,58483,0,0
2860000,66232,7705,58527,0,0
2865000,66283,7707,58576,0,0
2870000,66400,7715,58685,0,0
2875000,66461,7719,58742,0,0
2880000,66580,7731,58849,0,0
2885000,66661,7739,58922,0,0
2890000,66732,7749,58983,0,0
2895000,66836,7755,59081,0,0
2900000,66914,7760,59154,0,0
2905000,66965,7767,59198,0,0
2910000,67035,7772,59263,0,0
2913952,67064,7774,59290,0,0