5000,46,11,35,0,0
10000,60,17,43,0,0
15000,85,22,63,0,0
20000,151,39,112,0,0
25000,194,47,147,0,0
30000,214,49,165,0,0
35000,277,71,206,0,0
40000,336,86,250,0,0
45000,364,91,273,0,0
50000,404,97,307,0,0
55000,429,103,326,0,0
60000,447,104,343,0,0
65000,479,112,367,0,0
70000,507,123,384,0,0
75000,536,133,403,0,0
80000,578,140,438,0,0
85000,602,149,453,0,0
90000,617,149,468,0,0
95000,626,149,477,0,0
100000,639,150,489,0,0
105000,667,157,510,0,0
110000,687,157,530,0,0
115000,698,157,541,0,0
120000,721,160,561,0,0
125000,748,163,585,0,0
130000,764,165,599,0,0
135000,792,171,621,0,0
140000,817,178,639,0,0
145000,873,204,669,0,0
150000,906,211,695,0,0
155000,925,213,712,0,0
160000,946,216,730,0,0
165000,968,218,750,0,0
170000,986,220,766,0,0
175000,1017,225,792,0,0
180000,1038,231,807,0,0
185000,1054,234,820,0,0
190000,1113,241,872,0,0
195000,1139,245,894,0,0
200000,1164,250,914,0,0
205000,1198,256,942,0,0
210000,1215,259,956,0,0
215000,1237,263,974,0,0
220000,1288,278,1010,0,0
225000,1313,283,1030,0,0
230000,1352,291,1061,0,0
235000,1385,301,1084,0,0
240000,1405,305,1100,0,0
245000,1413,307,1106,0,0
250000,1432,308,1124,0,0
255000,1457,309,1148,0,0
260000,1483,313,1170,0,0
265000,1504,318,1186,0,0
270000,1530,324,1206,0,0
275000,1587,344,1243,0,0
280000,1609,347,1262,0,0
285000,1662,367,1295,0,0
290000,1711,385,1326,0,0
295000,1748,398,1350,0,0
300000,1761,400,1361,0,0
305000,1799,408,1391,0,0
310000,1823,417,1406,0,0
315000,1864,423,1441,0,0
320000,1884,424,1460,0,0
325000,1911,428,1483,0,0
330000,1950,434,1516,0,0
335000,1998,444,1554,0,0
340000,2028,451,1577,0,0
345000,2066,454,1612,0,0
350000,2086,456,1630,0,0
355000,2130,461,1669,0,0
360000,2163,468,1695,0,0
365000,2180,472,1708,0,0
370000,2214,477,1737,0,0
375000,2249,482,1767,0,0
380000,2256,483,1773,0,0
385000,2279,484,1795,0,0
390000,2342,497,1845,0,0
395000,2385,506,1879,0,0
400000,2417,512,1905,0,0
405000,2466,520,1946,0,0
410000,2521,537,1984,0,0
415000,2583,549,2034,0,0
420000,2619,558,2061,0,0
425000,2643,562,2081,0,0
430000,2674,565,2109,0,0
435000,2700,570,2130,0,0
440000,2740,573,2167,0,0
445000,2782,580,2202,0,0
450000,2843,599,2244,0,0
455000,2881,610,2271,0,0
460000,2946,633,2313,0,0
465000,2966,634,2332,0,0
470000,3010,640,2370,0,0
475000,3053,651,2402,0,0
480000,3089,655,2434,0,0
485000,3127,665,2462,0,0
490000,3185,675,2510,0,0
495000,3211,679,2532,0,0
500000,3250,691,2559,0,0
505000,3286,700,2586,0,0
510000,3324,708,2616,0,0
515000,3363,718,2645,0,0
520000,3419,729,2690,0,0
525000,3461,735,2726,0,0
530000,3472,736,2736,0,0
535000,3525,749,2776,0,0
540000,3564,750,2814,0,0
545000,3587,751,2836,0,0
550000,3614,757,2857,0,0
555000,3634,758,2876,0,0
560000,3676,760,2916,0,0
565000,3742,777,2965,0,0
570000,3776,785,2991,0,0
575000,3835,797,3038,0,0
580000,3858,800,3058,0,0
585000,3895,805,3090,0,0
590000,3908,806,3102,0,0
595000,3973,824,3149,0,0
600000,3996,826,3170,0,0
605000,4044,833,3211,0,0
610000,4080,837,3243,0,0
615000,4097,840,3257,0,0
620000,4116,842,3274,0,0
625000,4154,849,3305,0,0
630000,4199,855,3344,0,0
635000,4232,863,3369,0,0
640000,4264,867,3397,0,0
645000,4285,870,3415,0,0
650000,4319,884,3435,0,0
655000,4353,893,3460,0,0
660000,4387,899,3488,0,0
665000,4426,906,3520,0,0
670000,4461,916,3545,0,0
675000,4497,923,3574,0,0
680000,4515,928,3587,0,0
685000,4565,937,3628,0,0
690000,4608,948,3660,0,0
695000,4627,950,3677,0,0
700000,4660,954,3706,0,0
705000,4682,959,3723,0,0
710000,4704,963,3741,0,0
715000,4717,964,3753,0,0
720000,4761,980,3781,0,0
725000,4802,993,3809,0,0
730000,4829,999,3830,0,0
735000,4848,1003,3845,0,0
740000,4871,1009,3862,0,0
745000,4912,1016,3896,0,0
750000,4950,1023,3927,0,0
755000,4989,1031,3958,0,0
760000,5016,1035,3981,0,0
765000,5039,1039,4000,0,0
770000,5073,1046,4027,0,0
775000,5102,1050,4052,0,0
780000,5141,1054,4087,0,0
785000,5181,1062,4119,0,0
790000,5217,1065,4152,0,0
795000,5252,1071,4181,0,0
800000,5288,1077,4211,0,0
805000,5327,1086,4241,0,0
810000,5359,1089,4270,0,0
815000,5393,1093,4300,0,0
820000,5417,1100,4317,0,0
825000,5442,1102,4340,0,0
830000,5488,1108,4380,0,0
835000,5511,1115,4396,0,0
840000,5533,1121,4412,0,0
845000,5574,1130,4444,0,0
850000,5598,1131,4467,0,0
855000,5633,1133,4500,0,0
860000,5641,1133,4508,0,0
865000,5671,1137,4534,0,0
870000,5680,1138,4542,0,0
875000,5704,1142,4562,0,0
880000,5765,1147,4618,0,0
885000,5787,1149,4638,0,0
890000,5829,1157,4672,0,0
895000,5859,1163,4696,0,0
900000,5885,1167,4718,0,0
905000,5909,1172,4737,0,0
910000,5933,1175,4758,0,0
915000,5962,1181,4781,0,0
920000,5982,1185,4797,0,0
925000,6003,1188,4815,0,0
930000,6036,1192,4844,0,0
935000,6062,1193,4869,0,0
940000,6103,1199,4904,0,0
945000,6135,1204,4931,0,0
950000,6147,1204,4943,0,0
955000,6170,1209,4961,0,0
960000,6207,1213,4994,0,0
965000,6225,1215,5010,0,0
970000,6258,1222,5036,0,0
975000,6293,1231,5062,0,0
980000,6332,1247,5085,0,0
985000,6354,1252,5102,0,0
990000,6383,1264,5119,0,0
995000,6401,1272,5129,0,0
1000000,6429,1276,5153,0,0
1005000,6453,1277,5176,0,0
1010000,6474,1278,5196,0,0
1015000,6518,1283,5235,0,0
1020000,6524,1284,5240,0,0
1025000,6558,1291,5267,0,0
1030000,6592,1301,5291,0,0
1035000,6610,1301,5309,0,0
1040000,6628,1302,5326,0,0
1045000,6645,1303,5342,0,0
1050000,6664,1307,5357,0,0
1055000,6696,1314,5382,0,0
1060000,6723,1321,5402,0,0
1065000,6745,1324,5421,0,0
1070000,6777,1331,5446,0,0
1075000,6793,1333,5460,0,0
1080000,6807,1336,5471,0,0
1085000,6817,1336,5481,0,0
1090000,6830,1337,5493,0,0
1095000,6850,1340,5510,0,0
1100000,6879,1341,5538,0,0
1105000,6905,1344,5561,0,0
1110000,6933,1349,5584,0,0
1115000,6963,1354,5609,0,0
1120000,6998,1357,5641,0,0
1125000,7005,1359,5646,0,0
1130000,7032,1361,5671,0,0
1135000,7059,1361,5698,0,0
1140000,7078,1365,5713,0,0
1145000,7136,1377,5759,0,0
1150000,7218,1387,5831,0,0
1155000,7235,1389,5846,0,0
1160000,7262,1391,5871,0,0
1165000,7302,1398,5904,0,0
1170000,7354,1408,5946,0,0
1175000,7380,1411,5969,0,0
1180000,7431,1428,6003,0,0
1185000,7468,1436,6032,0,0
1190000,7606,1480,6126,0,0
1195000,7662,1494,6168,0,0
1200000,7733,1512,6221,0,0
1205000,7807,1521,6286,0,0
1210000,7830,1524,6306,0,0
1215000,7851,1531,6320,0,0
1220000,7902,1538,6364,0,0
1225000,7924,1542,6382,0,0
1230000,7966,1549,6417,0,0
1235000,8008,1558,6450,0,0
1240000,8040,1564,6476,0,0
1245000,8078,1571,6507,0,0
1250000,8123,1578,6545,0,0
1255000,8143,1581,6562,0,0
1260000,8170,1584,6586,0,0
1265000,8196,1588,6608,0,0
1270000,8219,1591,6628,0,0
1275000,8238,1596,6642,0,0
1280000,8259,1600,6659,0,0
1285000,8283,1603,6680,0,0
1290000,8311,1614,6697,0,0
1295000,8327,1615,6712,0,0
1300000,8347,1616,6731,0,0
1305000,8383,1619,6764,0,0
1310000,8419,1625,6794,0,0
1315000,8448,1630,6818,0,0
1320000,8470,1635,6835,0,0
1325000,8484,1636,6848,0,0
1330000,8517,1640,6877,0,0
1335000,8547,1643,6904,0,0
1340000,8561,1644,6917,0,0
1345000,8575,1647,6928,0,0
1350000,8588,1648,6940,0,0
1355000,8605,1649,6956,0,0
1360000,8626,1652,6974,0,0
1365000,8650,1653,6997,0,0
1370000,8678,1656,7022,0,0
1375000,8698,1663,7035,0,0
1380000,8716,1665,7051,0,0
1385000,8739,1668,7071,0,0
1390000,8756,1669,7087,0,0
1395000,8783,1679,7104,0,0
1400000,8811,1680,7131,0,0
1405000,8817,1680,7137,0,0
1410000,8827,1682,7145,0,0
1415000,8840,1684,7156,0,0
1420000,8850,1687,7163,0,0
1425000,8864,1689,7175,0,0
1430000,8883,1692,7191,0,0
1435000,8900,1693,7207,0,0
1440000,8913,1693,7220,0,0
1445000,8940,1696,7244,0,0
1450000,8965,1700,7265,0,0
1455000,8979,1703,7276,0,0
1460000,9000,1707,7293,0,0
1465000,9025,1710,7315,0,0
1470000,9062,1712,7350,0,0
1475000,9094,1717,7377,0,0
1480000,9107,1718,7389,0,0
1485000,9118,1718,7400,0,0
1490000,9128,1718,7410,0,0
1495000,9148,1722,7426,0,0
1500000,9194,1731,7463,0,0
1505000,9205,1734,7471,0,0
1510000,9229,1736,7493,0,0
1515000,9251,1739,7512,0,0
1520000,9278,1741,7537,0,0
1525000,9304,1748,7556,0,0
1530000,9331,1753,7578,0,0
1535000,9346,1755,7591,0,0
1540000,9359,1756,7603,0,0
1545000,9387,1759,7628,0,0
1550000,9449,1767,7682,0,0
1555000,9477,1769,7708,0,0
1560000,9538,1782,7756,0,0
1565000,9557,1784,7773,0,0
1570000,9587,1789,7798,0,0
1575000,9606,1791,7815,0,0
1580000,9635,1796,7839,0,0
1585000,9693,1806,7887,0,0
1590000,9711,1808,7903,0,0
1595000,9752,1816,7936,0,0
1600000,9783,1823,7960,0,0
1605000,9808,1825,7983,0,0
1610000,9831,1827,8004,0,0
1615000,9876,1835,8041,0,0
1620000,9897,1837,8060,0,0
1625000,9907,1838,8069,0,0
1630000,9967,1847,8120,0,0
1635000,9987,1850,8137,0,0
1640000,10071,1878,8193,0,0
1645000,10114,1885,8229,0,0
1650000,10133,1885,8248,0,0
1655000,10169,1888,8281,0,0
1660000,10215,1894,8321,0,0
1665000,10269,1906,8363,0,0
1670000,10288,1909,8379,0,0
1675000,10307,1911,8396,0,0
1680000,10329,1911,8418,0,0
1685000,10347,1914,8433,0,0
1690000,10409,1941,8468,0,0
1695000,10447,1950,8497,0,0
1700000,10470,1954,8516,0,0
1705000,10516,1966,8550,0,0
1710000,10574,1972,8602,0,0
1715000,10611,1975,8636,0,0
1720000,10635,1981,8654,0,0
1725000,10660,1984,8676,0,0
1730000,10690,1986,8704,0,0
1735000,10729,1995,8734,0,0
1740000,10792,2002,8790,0,0
1745000,10842,2012,8830,0,0
1750000,10890,2019,8871,0,0
1755000,10922,2031,8891,0,0
1760000,10966,2035,8931,0,0
1765000,11030,2050,8980,0,0
1770000,11060,2052,9008,0,0
1775000,11079,2053,9026,0,0
1780000,11113,2059,9054,0,0
1785000,11135,2059,9076,0,0
1790000,11213,2071,9142,0,0
1795000,11245,2071,9174,0,0
1800000,11316,2093,9223,0,0
1805000,11357,2100,9257,0,0
1810000,11382,2103,9279,0,0
1815000,11401,2107,9294,0,0
1820000,11438,2114,9324,0,0
1825000,11480,2121,9359,0,0
1830000,11512,2125,9387,0,0
1835000,11537,2127,9410,0,0
1840000,11556,2131,9425,0,0
1845000,11598,2141,9457,0,0
1850000,11619,2144,9475,0,0
1855000,11652,2146,9506,0,0
1860000,11680,2147,9533,0,0
1865000,11727,2154,9573,0,0
1870000,11766,2159,9607,0,0
1875000,11816,2171,9645,0,0
1880000,11848,2176,9672,0,0
1885000,11883,2183,9700,0,0
1890000,11906,2192,9714,0,0
1895000,11949,2197,9752,0,0
1900000,11993,2204,9789,0,0
1905000,12022,2207,9815,0,0
1910000,12054,2214,9840,0,0
1915000,12083,2217,9866,0,0
1920000,12117,2223,9894,0,0
1925000,12143,2227,9916,0,0
1930000,12208,2241,9967,0,0
1935000,12233,2246,9987,0,0
1940000,12247,2247,10000,0,0
1945000,12263,2247,10016,0,0
1950000,12299,2253,10046,0,0
1955000,12330,2258,10072,0,0
1960000,12355,2261,10094,0,0
1965000,12364,2261,10103,0,0
1970000,12401,2265,10136,0,0
1975000,12457,2280,10177,0,0
1980000,12518,2296,10222,0,0
1985000,12532,2297,10235,0,0
1990000,12587,2309,10278,0,0
1995000,12626,2316,10310,0,0
2000000,12652,2319,10333,0,0
2005000,12689,2324,10365,0,0
2010000,12711,2327,10384,0,0
2015000,12726,2328,10398,0,0
2020000,12755,2333,10422,0,0
2025000,12795,2342,10453,0,0
2030000,12813,2344,10469,0,0
2035000,12849,2351,10498,0,0
2040000,12864,2357,10507,0,0
2045000,12896,2359,10537,0,0
2050000,12933,2364,10569,0,0
2055000,12943,2364,10579,0,0
2060000,12958,2369,10589,0,0
2065000,12968,2369,10599,0,0
2070000,13008,2371,10637,0,0
2075000,13018,2372,10646,0,0
2080000,13061,2378,10683,0,0
2085000,13115,2390,10725,0,0
2090000,13155,2398,10757,0,0
2095000,13216,2413,10803,0,0
2100000,13240,2414,10826,0,0
2105000,13269,2424,10845,0,0
2110000,13289,2426,10863,0,0
2115000,13340,2436,10904,0,0
2120000,13367,2442,10925,0,0
2125000,13427,2455,10972,0,0
2130000,13496,2473,11023,0,0
2135000,13541,2479,11062,0,0
2140000,13578,2486,11092,0,0
2145000,13632,2493,11139,0,0
2150000,13714,2512,11202,0,0
2155000,13745,2520,11225,0,0
2160000,13764,2522,11242,0,0
2165000,13783,2525,11258,0,0
2170000,13815,2534,11281,0,0
2175000,13862,2538,11324,0,0
2180000,13929,2558,11371,0,0
2185000,13983,2569,11414,0,0
2190000,14076,2598,11478,0,0
2195000,14119,2611,11508,0,0
2200000,14162,2618,11544,0,0
2205000,14215,2627,11588,0,0
2210000,14248,2636,11612,0,0
2215000,14274,2643,11631,0,0
2220000,14328,2654,11674,0,0
2225000,14441,2683,11758,0,0
2230000,14511,2700,11811,0,0
2235000,14595,2716,11879,0,0
2240000,14630,2723,11907,0,0
2245000,14683,2730,11953,0,0
2250000,14723,2739,11984,0,0
2255000,14755,2744,12011,0,0
2260000,14813,2752,12061,0,0
2265000,14843,2756,12087,0,0
2270000,14877,2764,12113,0,0
2275000,14911,2774,12137,0,0
2280000,14956,2780,12176,0,0
2285000,15010,2800,12210,0,0
2290000,15020,2803,12217,0,0
2295000,15053,2809,12244,0,0
2300000,15082,2814,12268,0,0
2305000,15122,2817,12305,0,0
2310000,15151,2821,12330,0,0
2315000,15191,2827,12364,0,0
2320000,15219,2832,12387,0,0
2325000,15233,2833,12400,0,0
2330000,15259,2838,12421,0,0
2335000,15273,2841,12432,0,0
2340000,15287,2842,12445,0,0
2345000,15309,2844,12465,0,0
2350000,15379,2864,12515,0,0
2355000,15406,2870,12536,0,0
2360000,15447,2876,12571,0,0
2365000,15488,2881,12607,0,0
2370000,15525,2888,12637,0,0
2375000,15568,2894,12674,0,0
2380000,15596,2898,12698,0,0
2385000,15621,2900,12721,0,0
2390000,15647,2901,12746,0,0
2395000,15669,2902,12767,0,0
2400000,15701,2908,12793,0,0
2405000,15725,2911,12814,0,0
2410000,15745,2913,12832,0,0
2415000,15762,2913,12849,0,0
2420000,15771,2915,12856,0,0
2425000,15783,2915,12868,0,0
2430000,15801,2917,12884,0,0
2435000,15841,2925,12916,0,0
2440000,15854,2926,12928,0,0
2445000,15869,2931,12938,0,0
2450000,15904,2937,12967,0,0
2455000,15921,2939,12982,0,0
2460000,15952,2943,13009,0,0
2465000,15971,2944,13027,0,0
2470000,15984,2946,13038,0,0
2475000,15997,2946,13051,0,0
2480000,16019,2947,13072,0,0
2485000,16050,2952,13098,0,0
2490000,16080,2959,13121,0,0
2495000,16085,2959,13126,0,0
2500000,16110,2966,13144,0,0
2505000,16121,2967,13154,0,0
2510000,16155,2970,13185,0,0
2515000,16179,2971,13208,0,0
2520000,16198,2972,13226,0,0
2525000,16231,2975,13256,0,0
2530000,16256,2979,13277,0,0
2535000,16289,2984,13305,0,0
2540000,16316,2991,13325,0,0
2545000,16330,2992,13338,0,0
2550000,16347,2994,13353,0,0
2555000,16359,2994,13365,0,0
2560000,16377,2997,13380,0,0
2565000,16390,2999,13391,0,0
2570000,16407,3000,13407,0,0
2575000,16415,3002,13413,0,0
2580000,16428,3003,13425,0,0
2585000,16446,3004,13442,0,0
2590000,16451,3004,13447,0,0
2595000,16467,3005,13462,0,0
2600000,16481,3007,13474,0,0
2605000,16505,3014,13491,0,0
2610000,16516,3015,13501,0,0
2615000,16529,3017,13512,0,0
2620000,16539,3019,13520,0,0
2625000,16554,3019,13535,0,0
2630000,16584,3024,13560,0,0
2635000,16592,3024,13568,0,0
2640000,16614,3027,13587,0,0
2645000,16635,3028,13607,0,0
2650000,16657,3030,13627,0,0
2655000,16671,3033,13638,0,0
2660000,16700,3048,13652,0,0
2665000,16706,3048,13658,0,0
2670000,16714,3049,13665,0,0
2675000,16726,3049,13677,0,0
2680000,16739,3051,13688,0,0
2685000,16755,3052,13703,0,0
2690000,16777,3052,13725,0,0
2695000,16806,3056,13750,0,0
2700000,16821,3057,13764,0,0
2705000,16842,3060,13782,0,0
2710000,16850,3060,13790,0,0
2715000,16880,3067,13813,0,0
2720000,16900,3069,13831,0,0
2725000,16948,3083,13865,0,0
2730000,16957,3083,13874,0,0
2735000,16964,3083,13881,0,0
2740000,16979,3084,13895,0,0
2745000,16994,3085,13909,0,0
2750000,17021,3089,13932,0,0
2755000,17036,3090,13946,0,0
2760000,17047,3090,13957,0,0
2765000,17083,3092,13991,0,0
2770000,17102,3092,14010,0,0
2775000,17111,3092,14019,0,0
2780000,17127,3093,14034,0,0
2785000,17139,3094,14045,0,0
2790000,17150,3095,14055,0,0
2795000,17170,3099,14071,0,0
2800000,17195,3105,14090,0,0
2805000,17204,3105,14099,0,0
2810000,17218,3105,14113,0,0
2815000,17233,3108,14125,0,0
2820000,17243,3108,14135,0,0
2825000,17270,3112,14158,0,0
2830000,17295,3118,14177,0,0
2835000,17312,3118,14194,0,0
2840000,17324,3121,14203,0,0
2845000,17338,3122,14216,0,0
2850000,17341,3122,14219,0,0
2855000,17347,3122,14225,0,0
2860000,17354,3122,14232,0,0
2865000,17367,3122,14245,0,0
2870000,17387,3123,14264,0,0
2875000,17404,3126,14278,0,0
2880000,17434,3129,14305,0,0
2885000,17451,3132,14319,0,0
2890000,17473,3138,14335,0,0
2895000,17497,3143,14354,0,0
2900000,17511,3147,14364,0,0
2905000,17528,3149,14379,0,0
2910000,17546,3151,14395,0,0
2913952,17549,3151,14398,0,0